0,0,0,0,0,0,0,0,0,0,0
0,3,6,6,0,0,0,6,3,6,0
0,3,3,3,0,0,0,3,6,3,0
0,3,6,6,0,0,0,3,6,3,0
0,0,0,0,0,0,0,0,0,0,0
0,0,0,0,4,0,5,0,0,0,0
0,0,0,0,0,0,0,0,0,0,0
