0,0,0,0,0,0,0,0,0,0,0
0,3,3,6,0,0,0,3,6,3,0
0,6,6,3,0,0,0,3,6,6,0
0,3,6,3,0,0,0,6,3,3,0
0,0,0,0,0,0,0,0,0,0,0
0,0,0,0,1,0,2,0,0,0,0
0,0,0,0,0,0,0,0,0,0,0
